sein : ser
haben : ter
werden : ficar, torna-se
können : poder
sagen : dizer
machen : fazer
geben : dar
kommen : vir
sollen : dever
wollen : querer 
gehen : ir 
wissen : saber 
sehen : ver 
lassen : deixar 
stehen : estar de pé 
finden : achar 
bleiben : ficar 
liegen : estar deitado 
heißen : chamar-se 
denken : pensar 
nehmen : tomar, pegar
tun : fazer
dürfen : poder, dever
glauben : acreditar
halten : segurar, parar
nennen : chamar
mögen : gostar de
zaigen : mostrar  
führen : conduzir
sprechen : falar
bringen : trazer
leben : viver
fahren : dirigir, andar de carro
meinen : achar, pensar
fragen : perguntar
kennen : saber
gelten : valer
stellen : colocar, pôr
spielen : jogar, tocar
arbeiten : trabalhar
brauchen : precisar
folgen : seguir
lernen : aprender
bestehen : passar bem
verstehen : entender
setzen : botar, colocar, pôr
bekommen : receber
beginnen : começar
versuchen : tentar
schreiben : escrever
laufen : correr
erklären : explicar
entsprechen : corresponder
sitzen : sentar
ziehen : puxar
scheinen : brilhar
fallen : cair
gehören : pertencer
entstehen : originar-se
erhalten : receber
treffen : encontrar
suchen : procurar
legen : colocar, pôr
haldeln : negociar
erreichen : alcançar, conseguir
tragen : carregar, levar
schaffen : criar